_________CCCCCCCCCCCCCC_____
_________CAAAAAAAAAAAAC_____
_________CAAAAAA*AAAAAC_____
_________CAAAAAAAAAAAAC_____
_________CAAABBBBBBAAACCCCC_
_________CAAAB____BAAACAAAC_
_________CAAAB____BAAACAAAC_
_____CCCCCAAABBBBBBAAACAA3C_
_____CAAAAA1AAAAAAAAAACCCCC_
_____CAAAAAAAAAAAAAAAAC
_CCCCCAAAAAAAAAAAAAAAAC_____
_CAAACAAABBBBBBAAACCCCC_____
_CAAACAAAB____BAAAC_________
_CAAACAAAB____BAAAC_________
_CCCCCAAABBBBBBAAAC_________
_____CAAAAAAAAAAAAC_________
_____CA2AAAAAAAAAAC_________
_____CAAAAAAAAAAAAC_________
_____CCCCCCCCCCCCCC_________
