BBBBBBBBBBBBBBBB
BAAAAAAAAAAAAAAB
BAACCAAAAAAAA*AB
BAACCAAAAAAAAAAB
BAAAAAA1AAACCAAB
BAAAAAAAAAACCAAB
BAA2AAAAAAAA3AAB
BBBBBBBBBBBBBBBB