ABBBABAABABBBABAAABBBABBBA
ABAAABBABABAB*BABABAAABAAA
ABBBABABBABBBABBAABBAABBBA
AAABAB2ABABAB1BABABA3AAABA
ABBBABAABABABABABABBBABBBA