BBBBBBBBBBBBBBBBBBB
BAAAAAB-----BAAAAAB
BACCCAB-----BACCCAB
BAC2CAB-----BAC3CAB
BACCCAB-----BACCCAB
BAAAAAB-----BAAAAAB
BBBBBBBBBBBBBBBBBBB
B-----BAA*AAB-----B
B-----BACCCAB-----B
B-----BAC1CAB-----B
B-----BACCCAB-----B
B-----BAAAAAB-----B
BBBBBBBBBBBBBBBBBBB