BBBBBBBBBBBBBBBB
BAAAAAAAAAAAAAAB
BAACCAAAAAAAAAAB
BAACCAAAAAAAAAAB
BAAAAAAAAAACCAAB
BAAAAAAAAAACCAAB
BAAAAAAAAAAAAAAB
BBBBBBBBBBBBBBBB