############
#--#----####
#--#----#--#
####----#--#
############
##---###--##
##---###--##
############