--CCCCCCCCCCCCCCCCCCCCCCCCCCC--
-CBAAC-----CBAACAAAC-----CBAAC-
CBAAAC----CBAAACAAAAC----CBA*AC
CBA2AC----CBAAC-CAAAC----CBAAAC
CBAAC-----CBAC---CAAC-----CBAAC
CCCCCCCCCCCCC-----CCCCCCCCCCCCC
CBAAC-----CBAC---CAAC-----CB3AC
CBAAAC----CBAAC-CAAAC----CBAAAC
CBAAAC----CB1AACAAAAC----CBAAAC
-CBAAC-----CBAACAAAC-----CBAAC-
--CCCCCCCCCCCCCCCCCCCCCCCCCCC--

