CCCCCCCCCCCC
CABABABABABC
CBAB3BABABAC
CABCCCCCCABC
CBAC____CBAC
C*BC____CABC
CBAC____CB2C
CABC____CABC
CBACCCCCCBAC
CAB1BABABABC
CBABABABABAC
CCCCCCCCCCCC
